11111111
10001D11
300P0001
10000001
10DDD011
10DDD0D1
10DDD011111111
10000000100001
1D100000D00001
10000001111111
11111111
@
2.5,2.5,1
3.5,2.5,1
5.5,1.5,3
@