111111111
100010001
100010001
100010001
1000D0001
100011D11
100010001
111111P11
@
@