11111111111
10000000001
11111000001
11110100001
10000000001
11111111111
@
@