1111111111111111111111111
1000000000000000000000001
1000000000000000000000001
100000000000000000000001
100000222220000303030001
100000200020000000000001
100000200020000300030001
111111111111111111111111
@
20.5,11.5,2
18.5,4.5,2
10.0,4.5,2
10.0,12.5,2
3.5,6.5,2
3.5,20.5,2
3.5,14.5,2
14.5,20.5,2
18.5,10.5,1
18.5,12.5,1
18.5,5.5,1
21.5,1.5,0
15.5,1.5,0
16.0,1.8,0
16.2,1.2,0
3.5,2.5,0
9.5,15.5,0
10.0,15.1,0
10.5,15.8,0
@