1,1,1,1,1,1,2,2,2,2,2,2,2,2,2,2                   3,3,3,3,3
1,0,0,0,0,0,0,0,0,0,0,0,0,0,0,2                 1,0,0,0,0,0,6
1,1,1,1,1,1,2,2,2,2,2,2,2,2,0,2               1,0,0,0,0,0,0,0,6
                          3,0,3             1,0,0,0,0,0,0,0,0,0,6
                          3,0,3             1,0,0,0,0,0,0,0,0,0,6
                          3,0,3           1,0,0,0,0,0,0,0,0,0,0,0,6
                          3,0,3           1,0,0,0,0,0,0,0,0,0,0,0,6
                          3,0,3         1,0,0,0,0,0,0,0,0,0,0,0,0,0,6
                          3,0,3         1,0,0,0,0,0,0,0,0,0,0,0,0,0,6
                          3,0,3         1,0,0,0,0,0,0,0,0,0,0,0,0,0,6
                          3,0,3,8,8,8,1,0,0,0,0,0,0,0,0,0,0,0,0,0,0,0,7
                        3,3,0,7,0,0,0,0,0,0,0,0,0,0,0,0,0,0,0,0,0,0,0,7
                        3,0,0,3,8,8,8,2,0,0,0,0,0,0,0,0,0,0,0,0,0,0,0,7
                        4,0,4,4         2,0,0,0,0,0,0,0,0,0,0,0,0,0,5
                      4,0,0,4           2,0,0,0,0,0,0,0,0,0,0,0,0,0,5
                      4,0,4,4           2,0,0,0,0,0,0,0,0,0,0,0,0,0,5
                    4,0,0,4               2,0,0,0,0,0,0,0,0,0,0,0,5
                  4,4,0,4,4               2,0,0,0,0,0,0,0,0,0,0,0,5
  6,          4,4,0,0,0,4                   2,0,0,0,0,0,0,0,0,0,5
6,0,6       4,4,0,0,0,0,4                   2,0,0,0,0,0,0,0,0,0,5
6,0,4,4,4,4,0,0,0,4,4,4                       2,0,0,0,0,0,0,0,5
6,0,0,0,0,0,0,4,4                               2,0,0,0,0,0,5
6,4,4,4,4,4,4                                     4,4,4,4,4
@